-12
12
-7
7
0000000000000000000000000
0000000000000000000000000
0000000000000000000000000
0000000000000000000000000
0000000000000000000000000
0000000000001111111000000
0000000000000001000100000
0000000000000101010100000
0000000000000101010100000
0000000000000101010100000
0000111111110101010000000
0000000000010100010000000
0000000000011111111100000
0000000000000000000000000
0000000000000000000000000
